wwwwwwwwwwwwwwwwwwwwwwwwwwwwwwwwwwwwwwwwwwwwwwww
wg.............................................w
wg.......w.....................................w
wg....................w........................w
wg.............................ww..............w
wg..............www..........................w.w
wg...............................ww..........B.w
wg.............................................w
wwwwwwwwwwwwwwwwwwwwwwwwwwwwwwwwwwwwwwwwwwwwwwww